TTTTTTTTT       TTTTTTTT
TTTTTTTT   X      TTTTTT
TTTTTTT            TTTTT
TTTTTT             TTTTT
TTTTTT     TT  X   TTTTT
TTTTTT     TTT     TTTTT
TTTTT      TT     TTTTTT
TTTTT             TTTTTT
TTTTT      TT     TTTTTT
TTTTTT     TTT    TTTTTT
TTTTTT             TTTTT
TTTTTT             TTTTT
TTTTT    TTTTTT    TTTTT
TTTTT     TTTT     TTTTT
TTTTT             TTTTTT
TTTTT       N      TTTTT
TTTTTT             TTTTT
TTTTTTT            TTTTT
TTTTTTTTT         TTTTTT
TTTTTTTTTT   A  TTTTTTTT
