TTTTTTTTT       TTTTTTTT
TTTTTTTTTPPPPPPPPTTTTTTT
TTTTTTT            TTTTT
TTTTTT             TTTTT
TTTTTT         X   TTTTT
TTTTTT             TTTTT
TTTTTTT           TTTTTT
TTTTTTTT          TTTTTT
TTTTTTT    T      TTTTTT
TTTTTT     TTT    TTTTTT
TTTTTT X   TTTT    TTTTT
TTTTTT     TTTT    TTTTT
TTTTT       TT     TTTTT
TTTTT              TTTTT
TTTTT             TTTTTT
TTTTT       X     TTTTTT
TTTTTT             TTTTT
TTTTTTT            TTTTT
TTTTTTTTT         TTTTTT
TTTTTTTTTT   A  TTTTTTTT
