TTTTTTTTTTTTTTTTTTTT
TTTTTTTTTTTTTTTTTTTT
TTTTT          TTTTT
TTTTT          TTTTT
TTTTT   TTTT   TTTTT
TTTTT   TTTT   TTTTT
TTTTT   TTTT   TTTTT
TTTTT          TTTTT
TTTTT          TTTTT
TTTTT          TTTTT
TTTTT          TTTTT
TTTTT          TTTTT
TTTTT          TTTTT
TTTTT   TTTT   TTTTT
TTTTT   TTTT   TTTTT
TTTTT   TTTT   TTTTT
TTTTT          TTTTT
TTTTT          TTTTT
TTTTT          TTTTT
TTTTT          TTTTT
TTTTT          TTTTT
TTTTT          TTTTT
TTTTTTTTTTTTTTTTTTTT
TTTTTTTTTTTTTTTTTTTT