TTTTTTTT         TTTTTTT
TTTTTTTT         TTTTTTT
TTTTTTT           TTTTTT
TTTTTT      X     TTTTTT
TTTTTT             TTTTT
TTTTTT     TT      TTTTT
TTTTTT    TTTT    TTTTTT
TTTTTT    TTTT    TTTTTT
TTTTTT             TTTTT
TTTTT             TTTTTT
TTTTT      G       TTTTT
TTTTTT            TTTTTT
TTTTT              TTTTT
TTTTT       T      TTTTT
TTTTT      TTTT    TTTTT
TTTTT      TTTT    TTTTT
TTTTTT      T      TTTTT
TTTTTTT            TTTTT
TTTTTTT           TTTTTT
TTTTTTT   A     TTTTTTTT